1. Animals (zwierzęta)
bird - ptak
bull - byk
cow - krowa
deer - jeleń
dolphin - delfin
donkey - osioł
duck - kaczka
elephant - słoń
fish - ryba
giraffe - żyrafa
lion - lew
monkey - małpa
mouse - mysz
rabbit - królik
shark - rekin
tiger - tygrys
zebra - zebra

2. Buildings (budynki)
bookshop - księgarnia
cathedral - katedra
clinic - klinika
club - klub
college - kolegium, college
gallery - galeria
house - dom
kiosk - kiosk
mosque - meczet
office - biuro
police station - komisariat policji
prison - więzienie
stadium - stadion
theatre - teatr
tower - wieża
university - uniwersytet

3. Clothes and accessories (ubrania i akcesoria)
blouse - bluzka damska
button - guzik
collar - kołnierz
costume - przebranie
dress - sukienka
handbag - torebka
jewellery - biżuteria
laundry - pranie
old-fashioned - staroświecki
pullover - pulower
shorts - krótkie spodenki
size - rozmiar
sleeve - rękaw
suit - garnitur
tights - rajstopy
uniform - mundur, mundurek

4. City (miasto)
bridge - most
fountain - fontanna
pavement - chodnik
sidewalk - chodnik
playground - plac zabaw
route - trasa
subway - metro
tunnel - tunel
underground - metro
zoo - zoo

5. Countryside (wieś)
earth - ziemia
farm - farma, gospodarstwo
field - pole
forest - las
hill - wzgórze
lake - jezioro
land - ziemia
pond - staw
region - rejon, teren
river - rzeka
sky - niebo
soil - ziemia, gleba
stream - potok
village - wioska
wood - drewno, las

6. Education (edukacja)
arithmetic - arytmetyka
art - sztuka
biology - biologia
chemistry - chemia
composition - wypracowanie, esej
corridor - korytarz
course - kurs
curriculum - program nauczania
degree - stopień naukowy
diploma - dyplom
economics - ekonomia
elementary - podstawowy
geography - geografia
intermediate - średnio zaawansowany
mathematics - matematyka
notice - powiadomienie, ogłoszenie
physics - fizyka
science - nauka
subject - temat, przedmiot szkolny

7. Environment (środowisko)
climate - klimat
eco-friendly - przyjazny dla środowiska
fumes - spaliny
gasoline - benzyna
litter - śmieci
natural habitat - naturalne środowisko
oil spill - wyciek ropy
ozone layer - warstwa ozonowa
pollution - zanieczyszczenie
rubbish - śmieci
traffic - ruch uliczny

8. Feelings (uczucia, emocje)

afraid - przestraszony
amazed - zdumiony
amused - rozbawiony
angry - rozzłoszczony
bored - znudzony
cheerful - radosny
curious - zaciekawiony
delighted - zachwycony
depressed - przygnębiony
disappointed - rozczarowany
embarrassed - zażenowany, speszony
excited - podekscytowany
jealous - zazdrosny
mad - wściekły
miserable - nieszczęśliwy
relaxed - zrelaksowany
sad - smutny
surprised - zaskoczony

9. Food and drink (jedzenie i picie)
bitter - gorzki
to boil - wrzeć
bread - chleb
buffet - bufet
butter - masło
cake - ciasto
canteen - stołówka
celery - seler
cereal - płatki zbożowe
cheese - ser
chips - frytki
chocolate - czekolada
cocoa - kakao
cookie - ciastko
corn - kukurydza
cream - śmietana
dessert - deser
diet - dieta
dish - danie
egg - jajko
flour - mąka
fresh - świeży
honey - miód
hungry - głodny
jam - dżem
jug - dzbanek
loaf - bochenek chleba
mushroom - grzyb
pan - patelnia
pasta - makaron
peanut - orzech ziemny
rice - ryż
salad - sałatka
salt - sól
soup - zupa
taste - smak (zmysł smaku)

10. Health (zdrowie)
accident - wypadek
ache - ból
bandage - bandaż
clean - czysty
dressing - opatrunek
emergency - nagły wypadek
fever - gorączka
flu - grypa
headache - ból głowy
operation - operacja
patient - pacjent
pill - pigułka
recover - wrócić do zdrowia
sore - rana
wound - rana

11. House (dom)
antique - zabytkowy
apartment - mieszkanie
balcony - balkon
basement - piwnica
basin - umywalka
blanket - koc
brick - cegła
bulb - żarówka
chimney - komin
clock - zegar
coal - węgiel
cupboard - kredens
desk - biurko
dishwasher - zmywarka
downstairs - na parterze
drawer - szuflada
entrance - wejście
fan - wiatrak
fence - płot
freezer - zamrażarka
furniture - meble
laundry - pranie
lock - zamek
mirror - lustro
neighbour - sąsiad
property - własność
rent - czynsz
rubbish - śmieci
stairs - schody
wall - ściana

12. Leisure time (czas wolny)
barbecue - grill
bodybuilding - kulturystyka
camp - obóz
chess - szachy
cruise - rejs
dance - taniec
doll - lalka
fiction - literatura piękna
guitar - gitara
jogging - jogging, bieganie
painting - obraz
sculpture - rzeźba
sightseeing - zwiedzanie miasta
sunbath - kąpiel słoneczna

13. Nature (natura)
autumn - jesień
spring - wiosna
summer - lato
winter - zima

branch - gałąź
bush - krzak
cave - jaskinia
cliff - klif
climate - klimat
coast - wybrzeże
continent - kontynent
desert - pustynia
environment - środowisko
flood - powódź
frost - mróz, szron
leaf - liść
moon - księżyc
planet - planeta
rainforest - las tropikalny
star - gwiazda
stone - kamień
sun - słońce
sunlight - światło słoneczne
sunrise - wschód słońca
sunset - zachód słońca
valley - dolina
waterfall - wodospad
wild - dziki
wildlife - fauna i flora

14. Shopping (zakupy)
advertisement - ogłoszenie
to book - zarezerwować
to buy - kupić
cheap - tani
to complain - narzekać, skarżyć się
to cost - kosztować
credit - kredyt
deposit - zaliczka
exchange - wymiana
inexpensive - niedrogi
luxurious - luksusowy
to order - zamówić
to pay - płacić
payment - zapłata
price - cena
to save - oszczędzać
to sell - sprzedać

15. Sport (sport)

athlete - sportowiec
baseball - baseball (dyscyplina sportowa), piłka do gry w baseball
bat - kij
champion - mistrz
coach - trener
competition - konkurencja, zawody
cycling - kolarstwo
diving - nurkowanie
gymnastics - gimnastyka
hit - uderzenie
kick - kopnięcie
net - siatka
racing - wyścigi
racket - rakieta
riding - jeździectwo
sailing - żeglarstwo
score - wynik
skiing - narciarstwo
team - drużyna
trainer - trener, instruktor
volleyball - siatkówka

16. Technology (technologia)
CD - płyta CD
cord - przewód
DVD - płyta DVD
Information Technology - technologia informacyjna
address - adres
code - kod
chat - czat
computer - komputer
to connect - łączyć się
to delete - usunąć
directory - katalog
electronic - elektroniczny
equipment - sprzęt
invention - wynalazek
keyboard - klawiatura
message - wiadomość
network - sieć
to print - drukować
program - program komputerowy
screen - ekran
SMS - krótka wiadomość tekstowa
software - oprogramowanie

17. Travelling (podróżowanie)
abroad - za granicą
aeroplane - samolot
airline - linia lotnicza
to arrive - przybyć
board - wejść (do autobusu, pociągu, samolotu)
border - granica państwowa
capital city - stolica
currency - waluta
customs - odprawa celna
delay - opóźnienie
destination - cel podróży
embassy - ambasada
fare - opłata za przejazd
guide - przewodnik
harbour - port
to hitchhike - jechać autostopem
journey - podróż
suitcase - walizka
tour - zwiedzanie, wycieczka
translation - tłumaczenie
trip - krótka podróż
vehicle - pojazd
voyage - podróż, wojaż

18. Weather (pogoda)
to blow - wiać
cloud - chmura
cloudy - pochmurny
cool - chłodny
dry - suchy
foggy - mglisty
forecast - prognoza
gale - wichura
icy - lodowaty
mild - łagodny
storm - burza, sztorm
sunshine - światło słoneczne
thunder - grzmot
wet - mokry
wind - wiatr
windy - wietrzny

19. Work (praca, zawód)
actor - aktor
actress - aktorka
architect - architekt
artist - artysta
assistant - pomocnik
boss - szef
butcher - rzeźnik
carpenter - stolarz, cieśla
chemist - farmaceuta
cook - kucharz
employee - pracownik
employer - pracodawca
engineer - inżynier
farmer - rolnik
fireman - strażak
guard - strażnik
hairdresser - fryzjer
journalist - dziennikarz
judge - sędzia
lawyer - prawnik
mechanic - mechanik
nurse - pielęgniarka
politician - polityk
priest - duchowny, ksiądz
scientist - naukowiec
soldier - żołnierz
taxi driver - taksówkarz
worker - robotnik